NOR	= "countries/Norkinia.txt"
AKA	= "countries/Akaria.txt"
ALX	= "countries/Alexia.txt"
ARC	= "countries/Arceus.txt"
KET	= "countries/Ketan.txt"
LOR	= "countries/Lorealeia.txt"
MYK	= "countries/Mykhos.txt"
PAC	= "countries/Pacis.txt"
PRU	= "countries/Pruzha.txt"
QAL	= "countries/Qalaan.txt"
QUI	= "countries/Quiche.txt"
AHL	= "countries/Ahalib.txt"
SRQ = "countries/Saraqa.txt"
KAI = "countries/Kaikanjei.txt"
UYN = "countries/Uyn'Hyr.txt"
JUB = "countries/Jubah.txt"
PEN = "countries/Peninsula.txt"
SOU = "countries/Southern Empire.txt"
QUA = "countries/Qualgong.txt"
MLJ = "countries/Mei Lung.txt"
KCU = "countries/Khatari.txt"
SWS = "countries/Shou Wei.txt"
CKM = "countries/Monk Rebellion.txt"
CON = "countries/Congwang.txt"
BAE = "countries/Baeliff.txt"
ARD = "countries/Ardiff.txt"
ARB = "countries/Arbindrothnia.txt"
SIN = "countries/Sinostria.txt"
SAU = "countries/Sausinia.txt"
HAL = "countries/Hallaxia.txt"
THE = "countries/Thenithria.txt"
LOE = "countries/Lorenthia.txt"
CAR = "countries/Carnetea.txt"
ARI = "countries/Arindroxia.txt"
FED = "countries/Third Federation.txt"
ALB = "countries/Albios.txt"
AEO = "countries/Aelo Senkaris.txt"
ILA = "countries/Ilakir.txt"
NDU = "countries/Nordundur"